1 1 1 1 1 1 1 1 1
1 2 2 2 2 2 2 2 1
1 2 3 3 0 0 3 3 1
1 2 3 0 0 0 0 3 1
1 2 3 0 4 4 0 3 1
1 2 3 0 4 4 0 3 1
1 2 2 2 2 2 2 2 1
1 1 1 1 1 1 1 1 1
