1 1 1 1 1 1 1 1 1 1 1 1 1 1 1 1 1 1 1 1 1 1 1 1 1 1 1 1 1 1 1 1 1 1 1 1 1 1 1 1 1 1 1 1 1 1 1 1 1 1
1 3 3 3 5 2 3 3 0 5 2 3 3 3 5 2 0 3 5 2 2 2 3 2 0 5 2 2 3 5 3 3 6 3 3 3 3 3 3 5 6 2 2 5 5 5 3 3 0 1
1 2 3 5 5 5 3 5 0 3 2 2 5 5 3 5 0 3 2 5 5 5 2 2 0 2 2 3 5 2 9 3 0 9 9 5 3 2 3 2 6 3 3 9 2 9 9 9 0 1
1 4 5 2 2 3 5 5 0 2 5 2 2 2 3 2 0 5 5 5 3 3 3 3 0 2 5 3 2 2 5 2 0 9 9 5 3 9 2 3 0 3 9 5 9 5 9 9 0 1
1 2 5 2 2 5 2 3 0 2 5 5 2 3 5 3 0 2 2 5 2 5 3 3 0 5 3 2 2 5 9 9 0 5 9 2 9 9 9 9 6 3 3 3 9 5 9 9 0 1
1 3 3 5 2 3 2 5 0 5 3 2 5 5 4 4 0 2 2 2 2 2 2 2 0 5 2 5 2 5 9 3 0 3 2 3 3 9 5 2 0 3 3 3 9 9 5 2 0 1
1 2 3 5 5 2 2 5 0 2 2 3 5 5 5 5 0 3 2 3 2 5 3 4 6 4 5 5 5 3 5 3 0 2 5 5 9 9 2 9 0 5 9 5 3 9 9 9 0 1
1 5 3 3 3 2 3 5 0 3 2 5 2 4 5 2 0 2 2 3 2 3 2 2 6 5 2 2 2 2 9 9 0 9 5 5 5 9 5 3 0 3 2 9 9 9 9 2 0 1
1 0 0 0 0 6 0 0 6 0 0 6 0 0 0 0 0 0 0 0 0 0 0 0 0 0 0 0 6 0 0 0 0 0 0 0 0 0 0 0 0 0 0 0 0 0 0 0 0 1
1 5 2 3 5 3 4 2 0 3 5 5 5 4 5 3 0 4 3 3 2 5 5 5 0 2 2 5 5 5 2 9 0 9 9 5 2 9 9 9 0 9 9 9 9 9 9 9 0 1
1 3 3 5 4 2 5 2 6 2 3 5 3 5 2 5 0 3 3 5 5 2 3 3 0 5 2 3 2 5 9 9 0 9 2 9 9 9 9 9 0 3 9 3 5 2 5 3 0 1
1 2 3 2 3 2 2 2 6 5 3 5 2 3 5 2 0 2 2 5 3 5 3 2 6 2 3 2 5 3 9 3 6 3 9 2 5 3 2 9 0 9 3 9 9 9 2 9 0 1
1 2 3 3 3 5 3 4 0 4 3 3 5 3 5 2 0 3 5 5 3 3 3 3 0 3 5 3 2 2 9 3 0 9 9 9 5 2 5 3 0 9 9 2 9 9 9 5 0 1
1 2 2 2 5 5 2 5 0 5 3 3 2 2 2 2 0 2 5 5 2 2 2 5 0 5 2 3 2 5 9 9 0 9 9 9 9 9 9 9 0 9 9 9 3 2 9 9 0 1
1 5 3 2 3 5 2 4 0 2 5 2 2 5 5 5 0 2 3 3 5 2 2 5 0 2 2 3 5 3 9 5 0 9 9 2 5 9 9 3 0 9 9 9 9 3 2 5 0 1
1 3 3 2 5 3 2 2 0 3 3 2 2 2 5 2 0 2 3 3 2 3 3 3 0 3 2 3 2 3 4 3 6 4 3 2 2 3 9 2 0 9 9 9 2 2 3 5 0 1
1 0 0 0 0 0 0 0 0 0 0 0 0 0 0 0 0 0 0 0 0 6 0 0 0 0 0 0 0 6 0 0 0 0 0 0 0 6 0 0 0 0 0 0 0 0 0 0 0 1
1 2 2 2 3 3 3 2 0 5 2 5 2 3 2 3 0 3 4 2 3 2 2 3 0 3 3 2 2 2 3 3 6 3 3 3 5 3 2 3 0 3 2 5 5 3 2 2 0 1
1 3 2 3 2 2 3 2 0 5 2 3 5 3 3 2 0 3 3 4 3 3 2 2 0 2 4 3 3 3 3 3 0 2 3 3 5 2 3 2 0 2 5 5 2 2 3 2 0 1
1 2 5 4 5 2 2 5 0 2 3 3 5 2 5 3 0 2 2 3 3 3 2 2 0 3 3 3 3 4 2 2 0 3 4 2 2 3 3 3 0 3 5 5 4 3 2 3 0 1
1 2 2 2 2 2 5 2 0 5 5 5 3 2 2 2 0 2 3 3 2 3 3 2 0 4 3 2 3 3 3 3 0 2 2 2 3 4 2 2 0 2 5 3 3 5 3 4 0 1
1 2 2 2 2 2 2 5 0 2 2 2 2 5 3 3 0 2 3 4 3 3 3 2 0 3 3 3 3 3 3 3 0 2 2 3 2 5 5 5 6 3 3 3 3 3 2 2 0 1
1 3 2 5 2 5 5 2 0 5 2 3 3 2 5 3 6 3 2 2 3 3 4 3 0 3 3 4 2 3 2 2 0 3 3 3 5 4 2 2 0 5 3 5 2 5 3 5 0 1
1 2 2 3 3 2 5 2 0 5 5 2 3 5 5 4 0 4 2 3 2 3 3 3 0 3 4 3 3 3 4 4 0 2 3 2 3 2 3 3 0 5 2 3 2 5 5 5 0 1
1 0 0 0 0 0 0 0 0 0 0 0 0 0 0 6 0 0 0 0 0 0 0 0 0 0 0 0 0 0 0 0 0 0 0 0 0 0 0 0 0 0 0 0 0 0 0 0 0 1
1 5 5 3 5 4 5 2 0 3 2 3 2 3 2 2 0 2 3 3 4 2 3 3 0 2 3 3 3 3 4 2 0 3 3 2 2 3 2 5 0 2 2 3 2 5 3 2 0 1
1 3 3 5 2 2 3 2 0 2 3 3 2 5 5 2 0 2 3 2 3 3 2 3 0 2 3 2 3 2 3 3 0 3 2 2 5 2 5 3 0 3 2 5 5 2 5 5 0 1
1 3 5 2 5 3 5 2 0 2 4 2 2 3 2 3 0 2 4 3 3 3 3 2 0 3 3 3 3 3 2 3 0 3 3 3 3 5 5 3 0 3 2 5 5 2 3 3 0 1
1 2 5 3 3 2 2 5 6 3 5 5 5 2 3 3 0 3 3 2 3 3 3 2 0 3 3 3 2 3 3 3 0 3 3 3 5 3 4 2 0 3 2 2 2 5 2 3 0 1
1 5 3 3 2 2 2 5 0 2 2 5 3 2 2 3 0 3 3 4 3 2 3 3 0 3 3 3 2 4 4 3 0 2 4 3 5 2 5 3 0 2 5 5 2 3 2 3 0 1
1 5 2 5 3 2 2 2 0 2 5 5 2 4 5 2 0 2 3 2 3 2 3 3 0 3 2 3 2 3 3 3 0 3 3 4 3 5 5 2 0 4 2 5 5 2 3 2 0 1
1 5 5 4 2 2 3 5 0 3 2 5 3 3 4 2 0 3 3 5 2 5 5 3 0 3 2 3 5 3 2 2 0 3 5 2 2 2 2 2 0 5 2 2 2 3 2 2 0 1
1 0 0 0 0 6 0 0 0 0 0 0 6 0 0 0 0 0 0 0 0 0 0 0 0 6 0 0 0 0 0 0 0 0 0 0 0 0 0 0 0 0 0 0 0 0 0 0 0 1
1 2 5 2 3 3 2 3 0 2 3 4 5 2 2 2 0 2 2 2 5 5 3 2 0 2 5 3 2 3 2 2 6 3 5 3 5 5 3 3 0 3 5 5 5 3 5 3 0 1
1 5 5 2 5 3 4 5 0 5 2 2 2 5 5 5 0 2 3 3 3 2 2 4 0 2 2 5 3 2 2 2 0 2 3 3 3 5 2 3 0 2 2 5 5 2 4 5 0 1
1 5 7 8 2 8 5 8 0 5 7 7 8 7 5 7 0 8 2 2 8 3 3 2 0 3 2 4 5 3 5 5 0 2 5 2 3 3 2 2 0 5 3 3 2 3 2 5 0 1
1 3 8 8 7 7 8 7 0 8 7 5 7 7 8 8 0 8 8 8 5 3 5 5 0 5 3 3 5 2 3 5 0 3 3 2 4 2 3 3 0 3 2 2 2 3 2 3 0 1
1 2 7 7 7 8 5 7 0 2 7 5 2 5 8 8 0 2 7 7 5 2 3 5 0 3 5 3 2 2 3 3 6 2 3 3 5 5 2 2 0 3 3 3 5 3 3 2 0 1
1 5 5 8 8 5 8 7 0 8 5 7 7 7 5 7 0 7 8 5 5 2 2 3 0 2 5 2 2 5 3 5 0 3 3 3 5 3 2 3 0 2 3 3 5 2 5 3 0 1
1 2 2 5 5 7 7 7 0 5 7 7 7 5 5 8 6 7 7 7 7 2 3 2 0 2 5 2 3 3 3 5 0 2 3 2 3 3 5 3 0 2 3 2 2 5 2 3 6 1
1 0 0 0 6 6 0 6 0 0 0 0 0 0 0 0 0 0 0 0 0 6 0 0 0 0 0 0 0 0 0 0 6 0 0 0 0 0 0 0 0 0 0 0 0 0 0 0 0 1
1 3 7 8 7 8 8 7 0 7 7 5 8 7 8 8 0 8 7 7 7 2 2 2 0 2 3 3 3 2 3 2 0 3 3 3 2 3 3 3 0 2 3 5 2 5 5 5 0 1
1 2 8 7 5 5 7 8 0 7 7 7 2 5 7 5 0 7 2 7 7 2 5 3 0 3 3 2 3 5 3 2 6 3 2 2 2 3 5 2 0 2 5 5 3 2 2 2 0 1
1 2 2 5 8 8 7 2 0 5 5 7 7 7 2 5 0 8 8 7 8 5 5 2 0 5 4 5 2 2 5 5 0 3 5 5 5 3 2 5 0 2 5 3 5 5 2 3 0 1
1 3 8 7 5 8 7 7 0 8 7 8 5 7 8 8 6 5 5 5 7 3 2 2 0 3 2 3 5 2 4 2 0 5 2 3 5 5 2 4 0 5 3 5 3 2 2 3 0 1
1 5 5 7 5 2 7 5 0 2 7 8 5 5 5 8 6 7 5 7 8 2 2 3 0 5 2 5 5 5 2 2 0 4 4 2 3 3 2 3 0 3 5 3 5 5 5 5 0 1
1 3 5 8 5 7 8 5 0 8 8 2 8 5 8 7 0 5 7 8 5 2 5 5 0 5 5 2 2 2 5 2 0 2 4 3 2 3 4 5 0 2 2 3 2 3 5 5 0 1
1 2 7 7 8 8 8 8 0 5 8 7 7 2 7 8 0 5 5 7 5 2 2 2 0 2 2 2 2 5 5 2 0 3 2 2 3 5 2 5 0 5 5 3 5 3 2 2 0 1
1 0 0 0 0 6 0 0 0 0 0 0 0 0 0 0 6 0 6 0 0 6 6 0 0 0 0 6 0 0 0 0 0 0 0 0 0 0 0 0 0 0 0 0 0 0 0 0 0 1
1 1 1 1 1 1 1 1 1 1 1 1 1 1 1 1 1 1 1 1 1 1 1 1 1 1 1 1 1 1 1 1 1 1 1 1 1 1 1 1 1 1 1 1 1 1 1 1 1 1